1993,1,"Manchester Utd",42,67,31,36,84
1993,2,"Aston Villa",42,57,40,17,74
1993,3,"Norwich City",42,61,65,-4,72
1993,4,Blackburn,42,68,46,22,71
1993,5,QPR,42,63,55,8,63
1993,6,Liverpool,42,62,55,7,59
1993,7,"Sheffield Wed",42,55,51,4,59
1993,8,Tottenham,42,60,66,-6,59
1993,9,"Manchester City",42,56,51,5,57
1993,10,Arsenal,42,40,38,2,56
1993,11,Chelsea,42,51,54,-3,56
1993,12,Wimbledon,42,56,55,1,54
1993,13,Everton,42,53,55,-2,53
1993,14,"Sheffield Utd",42,54,53,1,52
1993,15,"Coventry City",42,52,57,-5,52
1993,16,"Ipswich Town",42,50,55,-5,52
1993,17,"Leeds United",42,57,62,-5,51
1993,18,Southampton,42,54,61,-7,50
1993,19,"Oldham Athletic",42,63,74,-11,49
1993,20,"Crystal Palace",42,48,61,-13,49
1993,21,Middlesbrough,42,54,75,-21,44
1993,22,"Nottingham Forest",42,41,62,-21,40
1994,1,"Manchester Utd",42,80,38,42,92
1994,2,Blackburn,42,63,36,27,84
1994,3,"Newcastle Utd",42,82,41,41,77
1994,4,Arsenal,42,53,28,25,71
1994,5,"Leeds United",42,65,39,26,70
1994,6,Wimbledon,42,56,53,3,65
1994,7,"Sheffield Wed",42,76,54,22,64
1994,8,Liverpool,42,59,55,4,60
1994,9,QPR,42,62,61,1,60
1994,10,"Aston Villa",42,46,50,-4,57
1994,11,"Coventry City",42,43,45,-2,56
1994,12,"Norwich City",42,65,61,4,53
1994,13,"West Ham",42,47,58,-11,52
1994,14,Chelsea,42,49,53,-4,51
1994,15,Tottenham,42,54,59,-5,45
1994,16,"Manchester City",42,38,49,-11,45
1994,17,Everton,42,42,63,-21,44
1994,18,Southampton,42,49,66,-17,43
1994,19,"Ipswich Town",42,35,58,-23,43
1994,20,"Sheffield Utd",42,42,60,-18,42
1994,21,"Oldham Athletic",42,42,68,-26,40
1994,22,"Swindon Town",42,47,100,-53,30
1995,1,Blackburn,42,80,39,41,89
1995,2,"Manchester Utd",42,77,28,49,88
1995,3,"Nottingham Forest",42,72,43,29,77
1995,4,Liverpool,42,65,37,28,74
1995,5,"Leeds United",42,59,38,21,73
1995,6,"Newcastle Utd",42,67,47,20,72
1995,7,Tottenham,42,66,58,8,62
1995,8,QPR,42,61,59,2,60
1995,9,Wimbledon,42,48,65,-17,56
1995,10,Southampton,42,61,63,-2,54
1995,11,Chelsea,42,50,55,-5,54
1995,12,Arsenal,42,52,49,3,51
1995,13,"Sheffield Wed",42,49,57,-8,51
1995,14,"West Ham",42,44,48,-4,50
1995,15,Everton,42,44,51,-7,50
1995,16,"Coventry City",42,44,62,-18,50
1995,17,"Manchester City",42,53,64,-11,49
1995,18,"Aston Villa",42,51,56,-5,48
1995,19,"Crystal Palace",42,34,49,-15,45
1995,20,"Norwich City",42,37,54,-17,43
1995,21,"Leicester City",42,45,80,-35,29
1995,22,"Ipswich Town",42,36,93,-57,27
1996,1,"Manchester Utd",38,73,35,38,82
1996,2,"Newcastle Utd",38,66,37,29,78
1996,3,Liverpool,38,70,34,36,71
1996,4,"Aston Villa",38,52,35,17,63
1996,5,Arsenal,38,49,32,17,63
1996,6,Everton,38,64,44,20,61
1996,7,Blackburn,38,61,47,14,61
1996,8,Tottenham,38,50,38,12,61
1996,9,"Nottingham Forest",38,50,54,-4,58
1996,10,"West Ham",38,43,52,-9,51
1996,11,Chelsea,38,46,44,2,50
1996,12,Middlesbrough,38,35,50,-15,43
1996,13,"Leeds United",38,40,57,-17,43
1996,14,Wimbledon,38,55,70,-15,41
1996,15,"Sheffield Wed",38,48,61,-13,40
1996,16,"Coventry City",38,42,60,-18,38
1996,17,Southampton,38,34,52,-18,38
1996,18,"Manchester City",38,33,58,-25,38
1996,19,QPR,38,38,57,-19,33
1996,20,Bolton,38,39,71,-32,29
1997,1,"Manchester Utd",38,76,44,32,75
1997,2,"Newcastle Utd",38,73,40,33,68
1997,3,Arsenal,38,62,32,30,68
1997,4,Liverpool,38,62,37,25,68
1997,5,"Aston Villa",38,47,34,13,61
1997,6,Chelsea,38,58,55,3,59
1997,7,"Sheffield Wed",38,50,51,-1,57
1997,8,Wimbledon,38,49,46,3,56
1997,9,"Leicester City",38,46,54,-8,47
1997,10,Tottenham,38,44,51,-7,46
1997,11,"Leeds United",38,28,38,-10,46
1997,12,"Derby County",38,45,58,-13,46
1997,13,Blackburn,38,42,43,-1,42
1997,14,Middlesbrough,38,51,60,-9,42
1997,15,"West Ham",38,39,48,-9,42
1997,16,Everton,38,44,57,-13,42
1997,17,Southampton,38,50,56,-6,41
1997,18,"Coventry City",38,38,54,-16,41
1997,19,Sunderland,38,35,53,-18,40
1997,20,"Nottingham Forest",38,31,59,-28,34
1998,1,Arsenal,38,68,33,35,78
1998,2,"Manchester Utd",38,73,26,47,77
1998,3,Liverpool,38,68,42,26,65
1998,4,Chelsea,38,71,43,28,63
1998,5,"Leeds United",38,57,46,11,59
1998,6,Blackburn,38,57,52,5,58
1998,7,"Aston Villa",38,49,48,1,57
1998,8,"West Ham",38,56,57,-1,56
1998,9,"Derby County",38,52,49,3,55
1998,10,"Leicester City",38,51,41,10,53
1998,11,"Coventry City",38,46,44,2,52
1998,12,Southampton,38,50,55,-5,48
1998,13,"Newcastle Utd",38,35,44,-9,44
1998,14,Tottenham,38,44,56,-12,44
1998,15,Wimbledon,38,34,46,-12,44
1998,16,"Sheffield Wed",38,52,67,-15,44
1998,17,Everton,38,41,56,-15,40
1998,18,Bolton,38,41,61,-20,40
1998,19,Barnsley,38,37,82,-45,35
1998,20,"Crystal Palace",38,37,71,-34,33
1999,1,"Manchester Utd",38,80,37,43,79
1999,2,Arsenal,38,59,17,42,78
1999,3,Chelsea,38,57,30,27,75
1999,4,"Leeds United",38,62,34,28,67
1999,5,"West Ham",38,46,53,-7,57
1999,6,"Aston Villa",38,51,46,5,55
1999,7,Liverpool,38,68,49,19,54
1999,8,"Derby County",38,40,45,-5,52
1999,9,Middlesbrough,38,48,54,-6,51
1999,10,"Leicester City",38,40,46,-6,49
1999,11,Tottenham,38,47,50,-3,47
1999,12,"Sheffield Wed",38,41,42,-1,46
1999,13,"Newcastle Utd",38,48,54,-6,46
1999,14,Everton,38,42,47,-5,43
1999,15,"Coventry City",38,39,51,-12,42
1999,16,Wimbledon,38,40,63,-23,42
1999,17,Southampton,38,37,64,-27,41
1999,18,"Charlton Ath",38,41,56,-15,36
1999,19,Blackburn,38,38,52,-14,35
1999,20,"Nottingham Forest",38,35,69,-34,30
2000,1,"Manchester Utd",38,97,45,52,91
2000,2,Arsenal,38,73,43,30,73
2000,3,"Leeds United",38,58,43,15,69
2000,4,Liverpool,38,51,30,21,67
2000,5,Chelsea,38,53,34,19,65
2000,6,"Aston Villa",38,46,35,11,58
2000,7,Sunderland,38,57,56,1,58
2000,8,"Leicester City",38,55,55,0,55
2000,9,"West Ham",38,52,53,-1,55
2000,10,Tottenham,38,57,49,8,53
2000,11,"Newcastle Utd",38,63,54,9,52
2000,12,Middlesbrough,38,46,52,-6,52
2000,13,Everton,38,59,49,10,50
2000,14,"Coventry City",38,47,54,-7,44
2000,15,Southampton,38,45,62,-17,44
2000,16,"Derby County",38,44,57,-13,38
2000,17,"Bradford City",38,38,68,-30,36
2000,18,Wimbledon,38,46,74,-28,33
2000,19,"Sheffield Wed",38,38,70,-32,31
2000,20,Watford,38,35,77,-42,24
2001,1,"Manchester Utd",38,79,31,48,80
2001,2,Arsenal,38,63,38,25,70
2001,3,Liverpool,38,71,39,32,69
2001,4,"Leeds United",38,64,43,21,68
2001,5,"Ipswich Town",38,57,42,15,66
2001,6,Chelsea,38,68,45,23,61
2001,7,Sunderland,38,46,41,5,57
2001,8,"Aston Villa",38,46,43,3,54
2001,9,"Charlton Ath",38,50,57,-7,52
2001,10,Southampton,38,40,48,-8,52
2001,11,"Newcastle Utd",38,44,50,-6,51
2001,12,Tottenham,38,47,54,-7,49
2001,13,"Leicester City",38,39,51,-12,48
2001,14,Middlesbrough,38,44,44,0,42
2001,15,"West Ham",38,45,50,-5,42
2001,16,Everton,38,45,59,-14,42
2001,17,"Derby County",38,37,59,-22,42
2001,18,"Manchester City",38,41,65,-24,34
2001,19,"Coventry City",38,36,63,-27,34
2001,20,"Bradford City",38,30,70,-40,26
2002,1,Arsenal,38,79,36,43,87
2002,2,Liverpool,38,67,30,37,80
2002,3,"Manchester Utd",38,87,45,42,77
2002,4,"Newcastle Utd",38,74,52,22,71
2002,5,"Leeds United",38,53,37,16,66
2002,6,Chelsea,38,66,38,28,64
2002,7,"West Ham",38,48,57,-9,53
2002,8,"Aston Villa",38,46,47,-1,50
2002,9,Tottenham,38,49,53,-4,50
2002,10,Blackburn,38,55,51,4,46
2002,11,Southampton,38,46,54,-8,45
2002,12,Middlesbrough,38,35,47,-12,45
2002,13,Fulham,38,36,44,-8,44
2002,14,"Charlton Ath",38,38,49,-11,44
2002,15,Everton,38,45,57,-12,43
2002,16,Bolton,38,44,62,-18,40
2002,17,Sunderland,38,29,51,-22,40
2002,18,"Ipswich Town",38,41,64,-23,36
2002,19,"Derby County",38,33,63,-30,30
2002,20,"Leicester City",38,30,64,-34,28
2003,1,"Manchester Utd",38,74,34,40,83
2003,2,Arsenal,38,85,42,43,78
2003,3,"Newcastle Utd",38,63,48,15,69
2003,4,Chelsea,38,68,38,30,67
2003,5,Liverpool,38,61,41,20,64
2003,6,Blackburn,38,52,43,9,60
2003,7,Everton,38,48,49,-1,59
2003,8,Southampton,38,43,46,-3,52
2003,9,"Manchester City",38,47,54,-7,51
2003,10,Tottenham,38,51,62,-11,50
2003,11,Middlesbrough,38,48,44,4,49
2003,12,"Charlton Ath",38,45,56,-11,49
2003,13,"Birmingham City",38,41,49,-8,48
2003,14,Fulham,38,41,50,-9,48
2003,15,"Leeds United",38,58,57,1,47
2003,16,"Aston Villa",38,42,47,-5,45
2003,17,Bolton,38,41,51,-10,44
2003,18,"West Ham",38,42,59,-17,42
2003,19,"West Brom",38,29,65,-36,26
2003,20,Sunderland,38,21,65,-44,19
2004,1,Arsenal,38,73,26,47,90
2004,2,Chelsea,38,67,30,37,79
2004,3,"Manchester Utd",38,64,35,29,75
2004,4,Liverpool,38,55,37,18,60
2004,5,"Newcastle Utd",38,52,40,12,56
2004,6,"Aston Villa",38,48,44,4,56
2004,7,"Charlton Ath",38,51,51,0,53
2004,8,Bolton,38,48,56,-8,53
2004,9,Fulham,38,52,46,6,52
2004,10,"Birmingham City",38,43,48,-5,50
2004,11,Middlesbrough,38,44,52,-8,48
2004,12,Southampton,38,44,45,-1,47
2004,13,Portsmouth,38,47,54,-7,45
2004,14,Tottenham,38,47,57,-10,45
2004,15,Blackburn,38,51,59,-8,44
2004,16,"Manchester City",38,55,54,1,41
2004,17,Everton,38,45,57,-12,39
2004,18,"Leicester City",38,48,65,-17,33
2004,19,"Leeds United",38,40,79,-39,33
2004,20,Wolves,38,38,77,-39,33
2005,1,Chelsea,38,72,15,57,95
2005,2,Arsenal,38,87,36,51,83
2005,3,"Manchester Utd",38,58,26,32,77
2005,4,Everton,38,45,46,-1,61
2005,5,Liverpool,38,52,41,11,58
2005,6,Bolton,38,49,44,5,58
2005,7,Middlesbrough,38,53,46,7,55
2005,8,"Manchester City",38,47,39,8,52
2005,9,Tottenham,38,47,41,6,52
2005,10,"Aston Villa",38,45,52,-7,47
2005,11,"Charlton Ath",38,42,58,-16,46
2005,12,"Birmingham City",38,40,46,-6,45
2005,13,Fulham,38,52,60,-8,44
2005,14,"Newcastle Utd",38,47,57,-10,44
2005,15,Blackburn,38,32,43,-11,42
2005,16,Portsmouth,38,43,59,-16,39
2005,17,"West Brom",38,36,61,-25,34
2005,18,"Crystal Palace",38,41,62,-21,33
2005,19,"Norwich City",38,42,77,-35,33
2005,20,Southampton,38,45,66,-21,32
2006,1,Chelsea,38,72,22,50,91
2006,2,"Manchester Utd",38,72,34,38,83
2006,3,Liverpool,38,57,25,32,82
2006,4,Arsenal,38,68,31,37,67
2006,5,Tottenham,38,53,38,15,65
2006,6,Blackburn,38,51,42,9,63
2006,7,"Newcastle Utd",38,47,42,5,58
2006,8,Bolton,38,49,41,8,56
2006,9,"West Ham",38,52,55,-3,55
2006,10,"Wigan Athletic",38,45,52,-7,51
2006,11,Everton,38,34,49,-15,50
2006,12,Fulham,38,48,58,-10,48
2006,13,"Charlton Ath",38,41,55,-14,47
2006,14,Middlesbrough,38,48,58,-10,45
2006,15,"Manchester City",38,43,48,-5,43
2006,16,"Aston Villa",38,42,55,-13,42
2006,17,Portsmouth,38,37,62,-25,38
2006,18,"Birmingham City",38,28,50,-22,34
2006,19,"West Brom",38,31,58,-27,30
2006,20,Sunderland,38,26,69,-43,15
2007,1,"Manchester Utd",38,83,27,56,89
2007,2,Chelsea,38,64,24,40,83
2007,3,Liverpool,38,57,27,30,68
2007,4,Arsenal,38,63,35,28,68
2007,5,Tottenham,38,57,54,3,60
2007,6,Everton,38,52,36,16,58
2007,7,Bolton,38,47,52,-5,56
2007,8,Reading,38,52,47,5,55
2007,9,Portsmouth,38,45,42,3,54
2007,10,Blackburn,38,52,54,-2,52
2007,11,"Aston Villa",38,43,41,2,50
2007,12,Middlesbrough,38,44,49,-5,46
2007,13,"Newcastle Utd",38,38,47,-9,43
2007,14,"Manchester City",38,29,44,-15,42
2007,15,"West Ham",38,35,59,-24,41
2007,16,Fulham,38,38,60,-22,39
2007,17,"Wigan Athletic",38,37,59,-22,38
2007,18,"Sheffield Utd",38,32,55,-23,38
2007,19,"Charlton Ath",38,34,60,-26,34
2007,20,Watford,38,29,59,-30,28
2008,1,"Manchester Utd",38,80,22,58,87
2008,2,Chelsea,38,65,26,39,85
2008,3,Arsenal,38,74,31,43,83
2008,4,Liverpool,38,67,28,39,76
2008,5,Everton,38,55,33,22,65
2008,6,"Aston Villa",38,71,51,20,60
2008,7,Blackburn,38,50,48,2,58
2008,8,Portsmouth,38,48,40,8,57
2008,9,"Manchester City",38,45,53,-8,55
2008,10,"West Ham",38,42,50,-8,49
2008,11,Tottenham,38,66,61,5,46
2008,12,"Newcastle Utd",38,45,65,-20,43
2008,13,Middlesbrough,38,43,53,-10,42
2008,14,"Wigan Athletic",38,34,51,-17,40
2008,15,Sunderland,38,36,59,-23,39
2008,16,Bolton,38,36,54,-18,37
2008,17,Fulham,38,38,60,-22,36
2008,18,Reading,38,41,66,-25,36
2008,19,"Birmingham City",38,46,62,-16,35
2008,20,"Derby County",38,20,89,-69,11
2009,1,"Manchester Utd",38,68,24,44,90
2009,2,Liverpool,38,77,27,50,86
2009,3,Chelsea,38,68,24,44,83
2009,4,Arsenal,38,68,37,31,72
2009,5,Everton,38,55,37,18,63
2009,6,"Aston Villa",38,54,48,6,62
2009,7,Fulham,38,39,34,5,53
2009,8,Tottenham,38,45,45,0,51
2009,9,"West Ham",38,42,45,-3,51
2009,10,"Manchester City",38,58,50,8,50
2009,11,"Wigan Athletic",38,34,45,-11,45
2009,12,"Stoke City",38,38,55,-17,45
2009,13,Bolton,38,41,53,-12,41
2009,14,Portsmouth,38,38,57,-19,41
2009,15,Blackburn,38,40,60,-20,41
2009,16,Sunderland,38,34,54,-20,36
2009,17,"Hull City",38,39,64,-25,35
2009,18,"Newcastle Utd",38,40,59,-19,34
2009,19,Middlesbrough,38,28,57,-29,32
2009,20,"West Brom",38,36,67,-31,32
2010,1,Chelsea,38,103,32,71,86
2010,2,"Manchester Utd",38,86,28,58,85
2010,3,Arsenal,38,83,41,42,75
2010,4,Tottenham,38,67,41,26,70
2010,5,"Manchester City",38,73,45,28,67
2010,6,"Aston Villa",38,52,39,13,64
2010,7,Liverpool,38,61,35,26,63
2010,8,Everton,38,60,49,11,61
2010,9,"Birmingham City",38,38,47,-9,50
2010,10,Blackburn,38,41,55,-14,50
2010,11,"Stoke City",38,34,48,-14,47
2010,12,Fulham,38,39,46,-7,46
2010,13,Sunderland,38,48,56,-8,44
2010,14,Bolton,38,42,67,-25,39
2010,15,Wolves,38,32,56,-24,38
2010,16,"Wigan Athletic",38,37,79,-42,36
2010,17,"West Ham",38,47,66,-19,35
2010,18,Burnley,38,42,82,-40,30
2010,19,"Hull City",38,34,75,-41,30
2010,20,Portsmouth,38,34,66,-32,28
2011,1,"Manchester Utd",38,78,37,41,80
2011,2,Chelsea,38,69,33,36,71
2011,3,"Manchester City",38,60,33,27,71
2011,4,Arsenal,38,72,43,29,68
2011,5,Tottenham,38,55,46,9,62
2011,6,Liverpool,38,59,44,15,58
2011,7,Everton,38,51,45,6,54
2011,8,Fulham,38,49,43,6,49
2011,9,"Aston Villa",38,48,59,-11,48
2011,10,Sunderland,38,45,56,-11,47
2011,11,"West Brom",38,56,71,-15,47
2011,12,"Newcastle Utd",38,56,57,-1,46
2011,13,"Stoke City",38,46,48,-2,46
2011,14,Bolton,38,52,56,-4,46
2011,15,Blackburn,38,46,59,-13,43
2011,16,"Wigan Athletic",38,40,61,-21,42
2011,17,Wolves,38,46,66,-20,40
2011,18,"Birmingham City",38,37,58,-21,39
2011,19,Blackpool,38,55,78,-23,39
2011,20,"West Ham",38,43,70,-27,33
2012,1,"Manchester City",38,93,29,64,89
2012,2,"Manchester Utd",38,89,33,56,89
2012,3,Arsenal,38,74,49,25,70
2012,4,Tottenham,38,66,41,25,69
2012,5,"Newcastle Utd",38,56,51,5,65
2012,6,Chelsea,38,65,46,19,64
2012,7,Everton,38,50,40,10,56
2012,8,Liverpool,38,47,40,7,52
2012,9,Fulham,38,48,51,-3,52
2012,10,"West Brom",38,45,52,-7,47
2012,11,"Swansea City",38,44,51,-7,47
2012,12,"Norwich City",38,52,66,-14,47
2012,13,Sunderland,38,45,46,-1,45
2012,14,"Stoke City",38,36,53,-17,45
2012,15,"Wigan Athletic",38,42,62,-20,43
2012,16,"Aston Villa",38,37,53,-16,38
2012,17,QPR,38,43,66,-23,37
2012,18,Bolton,38,46,77,-31,36
2012,19,Blackburn,38,48,78,-30,31
2012,20,Wolves,38,40,82,-42,25
2013,1,"Manchester Utd",38,86,43,43,89
2013,2,"Manchester City",38,66,34,32,78
2013,3,Chelsea,38,75,39,36,75
2013,4,Arsenal,38,72,37,35,73
2013,5,Tottenham,38,66,46,20,72
2013,6,Everton,38,55,40,15,63
2013,7,Liverpool,38,71,43,28,61
2013,8,"West Brom",38,53,57,-4,49
2013,9,"Swansea City",38,47,51,-4,46
2013,10,"West Ham",38,45,53,-8,46
2013,11,"Norwich City",38,41,58,-17,44
2013,12,Fulham,38,50,60,-10,43
2013,13,"Stoke City",38,34,45,-11,42
2013,14,Southampton,38,49,60,-11,41
2013,15,"Aston Villa",38,47,69,-22,41
2013,16,"Newcastle Utd",38,45,68,-23,41
2013,17,Sunderland,38,41,54,-13,39
2013,18,"Wigan Athletic",38,47,73,-26,36
2013,19,Reading,38,43,73,-30,28
2013,20,QPR,38,30,60,-30,25
2014,1,"Manchester City",38,102,37,65,86
2014,2,Liverpool,38,101,50,51,84
2014,3,Chelsea,38,71,27,44,82
2014,4,Arsenal,38,68,41,27,79
2014,5,Everton,38,61,39,22,72
2014,6,Tottenham,38,55,51,4,69
2014,7,"Manchester Utd",38,64,43,21,64
2014,8,Southampton,38,54,46,8,56
2014,9,"Stoke City",38,45,52,-7,50
2014,10,"Newcastle Utd",38,43,59,-16,49
2014,11,"Crystal Palace",38,33,48,-15,45
2014,12,"Swansea City",38,54,54,0,42
2014,13,"West Ham",38,40,51,-11,40
2014,14,Sunderland,38,41,60,-19,38
2014,15,"Aston Villa",38,39,61,-22,38
2014,16,"Hull City",38,38,53,-15,37
2014,17,"West Brom",38,43,59,-16,36
2014,18,"Norwich City",38,28,62,-34,33
2014,19,Fulham,38,40,85,-45,32
2014,20,"Cardiff City",38,32,74,-42,30
2015,1,Chelsea,38,73,32,41,87
2015,2,"Manchester City",38,83,38,45,79
2015,3,Arsenal,38,71,36,35,75
2015,4,"Manchester Utd",38,62,37,25,70
2015,5,Tottenham,38,58,53,5,64
2015,6,Liverpool,38,52,48,4,62
2015,7,Southampton,38,54,33,21,60
2015,8,"Swansea City",38,46,49,-3,56
2015,9,"Stoke City",38,48,45,3,54
2015,10,"Crystal Palace",38,47,51,-4,48
2015,11,Everton,38,48,50,-2,47
2015,12,"West Ham",38,44,47,-3,47
2015,13,"West Brom",38,38,51,-13,44
2015,14,"Leicester City",38,46,55,-9,41
2015,15,"Newcastle Utd",38,40,63,-23,39
2015,16,Sunderland,38,31,53,-22,38
2015,17,"Aston Villa",38,31,57,-26,38
2015,18,"Hull City",38,33,51,-18,35
2015,19,Burnley,38,28,53,-25,33
2015,20,QPR,38,42,73,-31,30
2016,1,"Leicester City",38,68,36,32,81
2016,2,Arsenal,38,65,36,29,71
2016,3,Tottenham,38,69,35,34,70
2016,4,"Manchester City",38,71,41,30,66
2016,5,"Manchester Utd",38,49,35,14,66
2016,6,Southampton,38,59,41,18,63
2016,7,"West Ham",38,65,51,14,62
2016,8,Liverpool,38,63,50,13,60
2016,9,"Stoke City",38,41,55,-14,51
2016,10,Chelsea,38,59,53,6,50
2016,11,Everton,38,59,55,4,47
2016,12,"Swansea City",38,42,52,-10,47
2016,13,Watford,38,40,50,-10,45
2016,14,"West Brom",38,34,48,-14,43
2016,15,"Crystal Palace",38,39,51,-12,42
2016,16,Bournemouth,38,45,67,-22,42
2016,17,Sunderland,38,48,62,-14,39
2016,18,"Newcastle Utd",38,44,65,-21,37
2016,19,"Norwich City",38,39,67,-28,34
2016,20,"Aston Villa",38,27,76,-49,17
2017,1,Chelsea,38,85,33,52,93
2017,2,Tottenham,38,86,26,60,86
2017,3,"Manchester City",38,80,39,41,78
2017,4,Liverpool,38,78,42,36,76
2017,5,Arsenal,38,77,44,33,75
2017,6,"Manchester Utd",38,54,29,25,69
2017,7,Everton,38,62,44,18,61
2017,8,Southampton,38,41,48,-7,46
2017,9,Bournemouth,38,55,67,-12,46
2017,10,"West Brom",38,43,51,-8,45
2017,11,"West Ham",38,47,64,-17,45
2017,12,"Leicester City",38,48,63,-15,44
2017,13,"Stoke City",38,41,56,-15,44
2017,14,"Crystal Palace",38,50,63,-13,41
2017,15,"Swansea City",38,45,70,-25,41
2017,16,Burnley,38,39,55,-16,40
2017,17,Watford,38,40,68,-28,40
2017,18,"Hull City",38,37,80,-43,34
2017,19,Middlesbrough,38,27,53,-26,28
2017,20,Sunderland,38,29,69,-40,24
2018,1,"Manchester City",38,106,27,79,100
2018,2,"Manchester Utd",38,68,28,40,81
2018,3,Tottenham,38,74,36,38,77
2018,4,Liverpool,38,84,38,46,75
2018,5,Chelsea,38,62,38,24,70
2018,6,Arsenal,38,74,51,23,63
2018,7,Burnley,38,36,39,-3,54
2018,8,Everton,38,44,58,-14,49
2018,9,"Leicester City",38,56,60,-4,47
2018,10,"Newcastle Utd",38,39,47,-8,44
2018,11,"Crystal Palace",38,45,55,-10,44
2018,12,Bournemouth,38,45,61,-16,44
2018,13,"West Ham",38,48,68,-20,42
2018,14,Watford,38,44,64,-20,41
2018,15,Brighton,38,34,54,-20,40
2018,16,Huddersfield,38,28,58,-30,37
2018,17,Southampton,38,37,56,-19,36
2018,18,"Swansea City",38,28,56,-28,33
2018,19,"Stoke City",38,35,68,-33,33
2018,20,"West Brom",38,31,56,-25,31
2019,1,"Manchester City",38,95,23,72,98
2019,2,Liverpool,38,89,22,67,97
2019,3,Chelsea,38,63,39,24,72
2019,4,Tottenham,38,67,39,28,71
2019,5,Arsenal,38,73,51,22,70
2019,6,"Manchester Utd",38,65,54,11,66
2019,7,Wolves,38,47,46,1,57
2019,8,Everton,38,54,46,8,54
2019,9,"Leicester City",38,51,48,3,52
2019,10,"West Ham",38,52,55,-3,52
2019,11,Watford,38,52,59,-7,50
2019,12,"Crystal Palace",38,51,53,-2,49
2019,13,"Newcastle Utd",38,42,48,-6,45
2019,14,Bournemouth,38,56,70,-14,45
2019,15,Burnley,38,45,68,-23,40
2019,16,Southampton,38,45,65,-20,39
2019,17,Brighton,38,35,60,-25,36
2019,18,"Cardiff City",38,34,69,-35,34
2019,19,Fulham,38,34,81,-47,26
2019,20,Huddersfield,38,22,76,-54,16
2020,1,Liverpool,38,85,33,52,99
2020,2,"Manchester City",38,102,35,67,81
2020,3,"Manchester Utd",38,66,36,30,66
2020,4,Chelsea,38,69,54,15,66
2020,5,"Leicester City",38,67,41,26,62
2020,6,Tottenham,38,61,47,14,59
2020,7,Wolves,38,51,40,11,59
2020,8,Arsenal,38,56,48,8,56
2020,9,"Sheffield Utd",38,39,39,0,54
2020,10,Burnley,38,43,50,-7,54
2020,11,Southampton,38,51,60,-9,52
2020,12,Everton,38,44,56,-12,49
2020,13,"Newcastle Utd",38,38,58,-20,44
2020,14,"Crystal Palace",38,31,50,-19,43
2020,15,Brighton,38,39,54,-15,41
2020,16,"West Ham",38,49,62,-13,39
2020,17,"Aston Villa",38,41,67,-26,35
2020,18,Bournemouth,38,40,65,-25,34
2020,19,Watford,38,36,64,-28,34
2020,20,"Norwich City",38,26,75,-49,21
2021,1,"Manchester City",38,83,32,51,86
2021,2,"Manchester Utd",38,73,44,29,74
2021,3,Liverpool,38,68,42,26,69
2021,4,Chelsea,38,58,36,22,67
2021,5,"Leicester City",38,68,50,18,66
2021,6,"West Ham",38,62,47,15,65
2021,7,Tottenham,38,68,45,23,62
2021,8,Arsenal,38,55,39,16,61
2021,9,"Leeds United",38,62,54,8,59
2021,10,Everton,38,47,48,-1,59
2021,11,"Aston Villa",38,55,46,9,55
2021,12,"Newcastle Utd",38,46,62,-16,45
2021,13,Wolves,38,36,52,-16,45
2021,14,"Crystal Palace",38,41,66,-25,44
2021,15,Southampton,38,47,68,-21,43
2021,16,Brighton,38,40,46,-6,41
2021,17,Burnley,38,33,55,-22,39
2021,18,Fulham,38,27,53,-26,28
2021,19,"West Brom",38,35,76,-41,26
2021,20,"Sheffield Utd",38,20,63,-43,23
2022,1,"Manchester City",38,99,26,73,93
2022,2,Liverpool,38,94,26,68,92
2022,3,Chelsea,38,76,33,43,74
2022,4,Tottenham,38,69,40,29,71
2022,5,Arsenal,38,61,48,13,69
2022,6,"Manchester Utd",38,57,57,0,58
2022,7,"West Ham",38,60,51,9,56
2022,8,"Leicester City",38,62,59,3,52
2022,9,Brighton,38,42,44,-2,51
2022,10,Wolves,38,38,43,-5,51
2022,11,"Newcastle Utd",38,44,62,-18,49
2022,12,"Crystal Palace",38,50,46,4,48
2022,13,Brentford,38,48,56,-8,46
2022,14,"Aston Villa",38,52,54,-2,45
2022,15,Southampton,38,43,67,-24,40
2022,16,Everton,38,43,66,-23,39
2022,17,"Leeds United",38,42,79,-37,38
2022,18,Burnley,38,34,53,-19,35
2022,19,Watford,38,34,77,-43,23
2022,20,"Norwich City",38,23,84,-61,22
2023,1,"Manchester City",38,94,33,61,89
2023,2,Arsenal,38,88,43,45,84
2023,3,"Manchester Utd",38,58,43,15,75
2023,4,"Newcastle Utd",38,68,33,35,71
2023,5,Liverpool,38,75,47,28,67
2023,6,Brighton,38,72,53,19,62
2023,7,"Aston Villa",38,51,46,5,61
2023,8,Tottenham,38,70,63,7,60
2023,9,Brentford,38,58,46,12,59
2023,10,Fulham,38,55,53,2,52
2023,11,"Crystal Palace",38,40,49,-9,45
2023,12,Chelsea,38,38,47,-9,44
2023,13,Wolves,38,31,58,-27,41
2023,14,"West Ham",38,42,55,-13,40
2023,15,Bournemouth,38,37,71,-34,39
2023,16,"Nottingham Forest",38,38,68,-30,38
2023,17,Everton,38,34,57,-23,36
2023,18,"Leicester City",38,51,68,-17,34
2023,19,"Leeds United",38,48,78,-30,31
2023,20,Southampton,38,36,73,-37,25
2024,1,"Manchester City",38,96,34,62,91
2024,2,Arsenal,38,91,29,62,89
2024,3,Liverpool,38,86,41,45,82
2024,4,"Aston Villa",38,76,61,15,68
2024,5,Tottenham,38,74,61,13,66
2024,6,Chelsea,38,77,63,14,63
2024,7,"Newcastle Utd",38,85,62,23,60
2024,8,"Manchester Utd",38,57,58,-1,60
2024,9,"West Ham",38,60,74,-14,52
2024,10,"Crystal Palace",38,57,58,-1,49
2024,11,Brighton,38,55,62,-7,48
2024,12,Bournemouth,38,54,67,-13,48
2024,13,Fulham,38,55,61,-6,47
2024,14,Wolves,38,50,65,-15,46
2024,15,Everton,38,40,51,-11,40
2024,16,Brentford,38,56,65,-9,39
2024,17,"Nottingham Forest",38,49,67,-18,36
2024,18,"Luton Town",38,52,85,-33,26
2024,19,Burnley,38,41,78,-37,24
2024,20,"Sheffield Utd",38,35,104,-69,16
